NO ./path_to_the_north_texture.xpm
SO ./path_to_the_south_texture.xpm
WE ./path_to_the_west_texture.xpm
EA ./path_to_the_east_texture.xpm

F 220,100,0

C 225,30,0


111111111111111111111111111111111111
111111111111000000000110000000000001
111111111111011000001110000000000001
111111111111001000000000000000001111
111111111111000001110000000000001
100000000011000001110111111111111
111101111111110111000000100010000
11110111111111011101010010001
00000000110101011100000010001
10000000000000001100000010001
100000000000000011010100100S1
1100000111010101111101111000111
11110111111101011101111010001
11111111111111111111111111111